#####################################################################################################
                                    #     #     #   #     # # #               # # # # #   #   #   # #
# # # ### # ############# ### # ##### ##### ##### ### ##### # # ####### ####### # # # # ### ### ### #
# # #   # #       #   # #   # # #       # #   # #         #           # # #               # # # # # #
### # # ### ####### ### ######### ####### # ### # ######### ### ######### # ############### # # # # #
#   # # #           # #   #   # #                   # #   # # # # # # # #     # # #     #           #
### ####### # # # ### # ### ### # ### ##### ######### # ### # ### # # # # ##### # # ##### ###########
#         # # # #       #   # #     #     #         # #         # #   #       # # # # # #     # #   #
# # # ####### ### ### ### ### # ##### ############### # ##### ### # ### ####### # # # # # ##### # ###
# # #   # #   #     #   #   #       #   #   # # # # #     # #             # # # # #   # #     #   # #
### # ### ### ### ### ### ### ########### ### # # # # ##### ### ### # # ### # # # # ### # ####### # #
#   # # #       # #       #                             # #   # # # # #               # #     #   # #
# # ### ### # ### ### # ### ##### # # ####### # # # ##### # ##### ######### # # # # ### # ####### # #
# #       # #   # #   #         # # #       # # # # # # #                 # # # # #         # # #   #
# # # ### # # ####### # # # ##### ### # # ####### ### # # ### ### ##### # ######### # # # ### # # ###
# # #   # # #   #     # # #     #   # # #     # #           #   #     # #     #     # # #           #
# ### ####### ##### # # # # ######### ### # ### ####### # ######### ##### ####### # # # # ### # # # #
# #       #       # # # # #       #     # #           # #         #     #   #     # # # #   # # # # #
# # # # # # # # # ### ##### # ####### ##### # ### # ##### # ####### ########### # ##### # ######### #
# # # # # # # # #   #     # #     # #     # #   # #   # # #     #           #   #     # #       #   #
# # ### # # ### # ### # ### # # ### ######### # # # ### ######### # ############# # # ### ######### #
# #   # # # #   # #   #   # # #             # # # #             # # # # # #   # # # #   #         # #
# # # # # ##### # # # ##### # ### # # ### # # ##### # ### # ######### # # ### # ##### # # # # # ### #
# # # # # #     # # #     # #   # # #   # # #     # #   # #       # # # #   #       # # # # # # # # #
# # # # ##### # # # # # ### # # # ### ####### # ### # ### # # # ### # # # ### ####### # ### ##### ###
# # # # #     # # # # #   # # # #   #       # #   # # # # # # #                     # #   # # # # # #
# ##### ### # # ##### # ### ### # ########### ######### ### ####### # # # # ##### ##### ##### # # # #
#   # # #   # #     # #   # # # #       # # #             # # #   # # # # #     #     #   #         #
# ### ##### ### ##### # ##### ### # # ### # ####### # # ##### # ##### # ### # ### ##### ### ### # # #
# #         #       # #         # # #             # # #     #       # #   # #   # #   #       # # # #
### ####### ### # ################### ### ####### ####### ### ### # # # # # # ##### ##### # #########
#   #         # #                   #   #       #       #       # # # # # # #           # #   #     #
# # ####### ##### # # ### # # # # ### ### ### ##### # ##### # ############### # ### # ### # ### #####
# #   #         # # #   # # # # # #     #   #     # #     # #   # # # #   # # #   # # #   #         #
# # ####### ######### ##### # ### # # ### # # # ##### # ### # ### # # # ### ### # ##### # # # # # # #
# # # #         #         # #   # # #   # # # #     # #   # #                 # #     # # # # # # # #
##### ##### # ##### # # # # # # ##### ##### ### ##### # ##### # # # # ################# ### ####### #
#           #   #   # # # # # #     #     #   #     # #     # # # # #           #     #   #       # #
### ### # # # ### # ####### ##### ### # ##### # # ##### # # # # # ### ##### ##### ##### ### # ### ###
# # #   # # #   # #       #     # #   #     # # #   #   # # # # # #       #           #   # #   #   #
# ##### ##### ### # # ##### # ##### # # # ##### # ##### # # ######### # ##### # ####### ### # ##### #
#         #     # # #     # #     # # # #     # #     # # #     #     #     # #       #   # #     # #
# ### # ##### ####### ####### ################# # ####### # ######### # # ##### # ############# #####
# #   # #       #           # # # #         # # #       # #     #     # #     # #       #     # # # #
# ### ### # # # # # # ##### ### # # ### # ### ### # # ##### ##### ### ### ############### ####### # #
# #     # # # # # # #     #           # #       # # #   # #   # # #     #         #     #     # #   #
# ### ####### ### # ####### ### # ####### # ######### ### ##### ##### ############# ##### ##### # ###
# #   # # #     # #       #   # #     # # #         #             #             #           # #     #
# ##### # ### ##### ### ### ##### # ### ### ##### # # # # # # # ##### # # # # ### ########### # #####
# #               #   # #       # #   # # #     # # # # # # # #     # # # # #         #             #
# ##### # # # # # # ####### # ##### ### # ##################### # # ########### # ##### ### ### # ###
# # #   # # # # # #     #   #   #               # # # # # #   # # #           # #     #   #   # #   #
### ### ### ### # # # ### # # # ### # # # ####### # # # # # ########### # # # ### # ### ### ##### # #
#       #     # # # #   # # # # #   # # #         #   # #       #     # # # #   # #       #   #   # #
####### ### # ### ####### ##### # # # ### # # ##### ### # ####### ####### # # ### # # # ########### #
#         # # #     #   #     # # # # #   # #         #     # #     #   # # #   # # # #     #   # # #
####### ### # ### ### ### # ####### # # # # # # ### ### ##### # ##### ####### ### # # # ####### # ###
#   #     # # #         # # #   #   # # # # # #   # #               # # #   #   # # # #   # # #     #
### ### ######### # # ####### ##### # # # ##### ##### ### # # # ##### # # ### ######### ### # # #####
#             #   # #     # #   #   # # # #             # # # #   #         #   # # # #       #     #
##### # # # # ### # # ##### # ##### ##### ### # ### # ####### ##### ### # ####### # # ### ##### #####
#     # # # #   # # #     # # #   # #       # #   # #       #         # #     #   #     # # # #     #
##### ####### # ### # ##### # # ####### # # ### ### # ### ### ### # ####### ##### # ####### # # ### #
#         #   #   # #                 # # # #     # #   #   #   # # # # # #   # # #   # # #       # #
# # # # ##### ####### ### # # # ### ### # # # # # ################### # # ##### # # ### # # #########
# # # #     #     #     # # # #   #   # # # # # #     # #           # # # # # # #             # #   #
# ##### ##### ##### # ##### ### ########### # # # # ### # ### # ##### # # # # # # ####### ##### # ###
# #         #     # #     #   #     #     # # # # #         # #           #             #           #
# ##### # ########### # # # # # ##### ### # ### # # # # ######### # # # ### ### # ### ### ### # #####
# # #   #           # # # # # #         # # #   # # # #         # # # #       # #   # #     # #     #
### ### # ### # ############# # # # ########### # ### # # ### ##### # # # # ##### ### ### ##### #####
#       #   # #             # # # #   # #     # # #   # #   #     # # # # #     #   # # # # # #   # #
### # # # # ### # # # ##### ### ### ### # ##### ##### # # # ############### # ######### ### # ##### #
#   # # # #   # # # #     #   #   #           # #     # # #           #     # # # # # #             #
# # ### ########### # # ########### # # # # # ##### # # ### ##### ####### # ### # # # ### ### ##### #
# # #         # # # # #           # # # # # #   #   # #   #     #     #   #           # #   # #   # #
# # ### ### ### # ##### # # # ##### # ### ### ### # # # ##### # # # ##### # ### # ##### # ##### #####
# # #     # #       #   # # #     # #   #   # #   # # #     # # # #     # #   # #                 # #
# ##### ##### ### ##### ##### ##### ##### # # ### ### # # ####### # ##### # # ##### ### # # # ##### #
# #             #     #   #       #     # # # #     # # #     #   #     # # #     #   # # # #       #
# # # # # # # ### # ##### # # # ### ####### # # # # # ### ####### # ######### # # # ### ##### # # # #
# # # # # # #   # #     # # # #   #       # # # # # # #       #   #     # #   # # #   #     # # # # #
##### # # # ####### # ######### ### ####### # # ######### # # ### ####### ### # ######### ###########
#     # # #       # # # # # #     #     # # # #       #   # # #             # #         #     # #   #
# # ### ### # ##### ### # # ### ######### ##### # # ##### ####### # ### # ##### # ### ### # ### # ###
# # #   #   #     #         #       #         # # #   #       #   #   # #   #   #   #   # #         #
# ######### # ##### # # # ##### # ### ####### # # # ##### # ####### ##### ### # # ### ### # # # # ###
# #         #     # # # #     # #   #       # # # #   #   # #           #   # # # # #   # # # # #   #
### # ### # # ####### # # # ######### ############# ##### # ####### ##### # ### ### ######### # # # #
#   # #   # #     # # # # #                   # #       # #   #         # # #             #   # # # #
### ######### ##### ### ### # # ### # ######### ### # # ### # ### # # ### # ### # # ######### #######
#   #                 # #   # #   # #       #     # # #   # # #   # #   # # #   # #         #       #
############# ### # # # ### # # # ### ### ##### ################### ##### # ### ### ### # ### # # # #
#               # # # #   # # # #   #   #   # #   #   # # # #           # # #     #   # #   # # # # #
### # ##### # # # ##### ### # # # # # ####### # ### ### # # ### # # # ##### # # ### # # # # ### # # #
#   # #     # # # # # # #   # # # # #                         # # # #     # # #   # # # # #   # # # #
### ##### # # ##### # ##### # ### # # # # # # # ### # # # # ##### # # # ####### # ##### ### # ##### #
#   #     # #             # #   # # # # # # # #   # # # # #     # # # #     #   #     # #   #     # #
### # # # ### ####### ### # # ##### ##### # ### ####### # # # # ### # # # ##### # # ### ### # # # # #
#   # # # #         #   # # #     #     # # #         # # # # #   # # # #   #   # #   # #   # # # #  
#####################################################################################################
